1111111111111111111111111111111111111111111111111111111111111111
1..............................11..............................1
1..p...........................11..............................1
1.....11111..........11111.....11.....11111..........11111.....1
1.....1..................1.....11.....1..................1.....1
1.....1..................1.....11.....1..................1.....1
1.....1........11........1.....11.....1........11........1.....1
1.....1.......1111.......1.....11.....1.......1111.......1.....1
1............111111............11............111111............1
1.............1111.............11.............1111.............1
1..............................11..............................1
1..............11..............................11..............1
1..............11..............................11..............1
1..............................11..............................1
1.............1111.............11.............1111.............1
1............111111............11............111111............1
1.....1.......1111.......1.....11.....1.......1111.......1.....1
1.....1........11........1.....11.....1........11........1.....1
1.....1..................1.....11.....1..................1.....1
1.....1..................1.....11.....1..................1.....1
1.....11111..........11111.....11.....11111..........11111.....1
1..............................11..............................1
1..............................11..............................1
111111111111111..111111111111111111111111111111..111111111111111
111111111111111..111111111111111111111111111111..111111111111111
1..............................11..............................1
1..............................11..............................1
1.....11111..........11111.....11.....11111..........11111.....1
1.....1..................1.....11.....1..................1.....1
1.....1..................1.....11.....1..................1.....1
1.....1........11........1.....11.....1........11........1.....1
1.....1.......1111.......1.....11.....1.......1111.......1.....1
1............111111............11............111111............1
1.............1111.............11.............1111.............1
1..............................11..............................1
1..............11..............................11..............1
1..............11..............................11..............1
1..............................11..............................1
1.............1111.............11.............1111.............1
1............111111............11............111111............1
1.....1.......1111.......1.....11.....1.......1111.......1.....1
1.....1........11........1.....11.....1........11........1.....1
1.....1..................1.....11.....1..................1.....1
1.....1..................1.....11.....1..................1.....1
1.....11111..........11111.....11.....11111..........11111.....1
1..............................11..............................1
1..............................11..............................1
1111111111111111111111111111111111111111111111111111111111111111